#
rLLLL3LLLLR
r.........R
r....F....R
r.........T
r.........R
r.........R
r.........T
r.........R
r.........R
r...F.....T
r.......P.R
r.........R
rrrrrrrrrrr
