#
rLLLLLLLLLR
r.........R
r.........R
r...rrr...T
r...r r...R
r...r r...R
r...r r...T
r...r r...R
r...r r...R
r...rrr...T
r.......P.R
r.........R
rrrrrrrrrrr
